#################################################################################################################################
#.#.#...#......eee......#.........#...#...........#...#.#.....#.#...................#...#.......#.....#...........#.#.....#.#.#.#
#......##..##########..####.###.....###..####....##.....###..##.###..######...#######..####.###.###..##.#####..####....####.....#
#.................#.....#.#.#.#.#...#.....#.#.#...#.#...#...............#...#.#...#.....#...#.....#...#.#.#.....#.........#.....#
###..####.###..######..##.###.###...#.#####.###...#####.#.....#############.###..##....####.###.###..####.#####.#####....####.###
#.....#...#.........#...........#.#.#.#...#.....#...#...#.#.#.#.#.........#.#.#...#.#.......#.#.#.....#.#.........#.#.#...#.#.#.#
#####.#...#.###....####..##.###.###.#.#..##...###..##...#.#####.#....####.......###.#########......####.#####.###.#.#.#.###...#.#
#.#...#.#.#.#...#...#.....#.#.#.....#.#...#.#.#.......#.#.....#.#.#.....#.......#.#...#.#...#.......#.........#.#.#.#.#.#.....#.#
#.#..######.###.#####..##.###.#########...###.#######.#######.#...#..##########.#.###.....###.#####.#######.###.###...#####..##.#
#.#...#.#.#.#.#...#.....#.#.....#.#.....#.........#...#.....#.#...#...#.......#.#...#.....#.#.#.......#.....#.......e.....#.....#
#.#####...###.#.###...###.###.....#...###..####.###.###..######.###########.....###.###.....###.###..######.###.###.e..########.#
#...#.....#...#.#...#.#.......#...#.#.#.......#.#.#.#.......#...#...#...#.#.#.......#...#.....#.#.........#.....#.#.#.....#.....#
#.#####..##.#####.###.#########..######......##.#.###..######.#####.###.....###...#####.#.#############..##..####.#.#.#######...#
#.#.#.#...#.#.....#.....#.....#...#.....#.#...#.#...#...#.....#.......#.......#.#.#...#.#.#...#.#.....#...#.......#.#.#.....#.#.#
#.#.........#####.###......####..##...#######.###..##.#####.....#####.#####.#####...###.#.###.......#####.#.###############.###.#
#.#.....#.....#.#.#...#.....#.......#.#...#.....#.....#.#...#...#.....#.#.#.#.......#...#.#.#.....#.#.....#.#.............#.....#
#.###...#######...#.###.#####....######.###..####.###...###.#######..##.#.###..##.###...###.#....####..####.#####...###......##.#
#.....#.#...#.#...#.#.#.#...#.#.........#.........#.#.....#.#...#.#.....#.......#.#...#.....#.#...#......ee.....#.#.#.#.#.....#.#
###..####.....#######...#...###########.###########.###.###.###...#...#####..######.#######.###..##....##......##.###.#########.#
#.#.......#.........#...#.#.#.....#.......#...#.......#.#...#.....#.#.#.#.#.........#.....#.#.......#...#.#.#...........#...#...#
#...###..####..######.#####...........###.....###.......###.#.###...#.#.#...#######.###.....#####..############.#######...###..##
#...#.....#.......#...#.......#.#...#.#.....#...#.#.#.....#.#.#.....#.#.#...#.........#.#...#.#.....#...#.#.....#.....#...#.....#
#..####...#####################.###.###################..####.#..####...#..##..####.#########....####.....###########.#...#.#####
#...#...#.#...#.#.#...#...#.#.....#...#.#...#.....#...#...#...#.....#...#...#...#.#.#.............#...#...#.#.#.......#.#.#.#...#
#..##...#####.....###....##.#...###...#.###.###..####.###########..##..####.#####.#####.#####.#########..##.#.#######.###.#...###
#...#.#...#.#.......#.......#.#.#...#.#.....#.....#.....#...#.......#...#.......#.......#.....#.....#.....#.#.#.......#.#.#...#.#
#####.#####....##...###.###...#####.#....########.#####...#########.###.###..########...#####......####.....#.###....##.#####...#
#.........#.....#.#.#...#.#...#...#.#.....................#...#.......#.#.....#...#...#.#.......#...#.#.#...#...#.#.............#
#..####..##.###########...#####..######.###..############.#.#######..##.###.###...#.###.#####.###..##.###..##..########.#####...#
#...#.....#.#.#.............#.....#.....#.....#.........#.#.#.#.......#...#.#.#.#.#.#...#.#...#.#.....#.#...#.......#.#.#.....#.#
#####.#####...#..##....######.....###...#.#######..######.#.#.#....##########.#.#...#####...###.#######...#####..####...###..####
#.#...#.#.....#...#.#...#.....#.#...#.#.#.#.....#...#...#.#.#.#.#...#.........#.#...#.......#.#...........#.#.#...#.#.....#.....#
#.###.#...###....######.#######.#####.#####.###.###....##.#.....###.###..####.#####.#####..##.###..########.#.#...#...###.#.#####
#.#...#...#.#.....#.#.#...#.........#.#.....#.#.#.........#.....#...#.......#.#...#.....#...#.........#.#...#.#.#.#...#.#.#.#...#
#.###...###.#######.#.###.#####..##.#.#..####.#####....##.#...###########..##.###.......#####..######...#.###.###.#####.###.###.#
#...#...#...#.......#...#.#.......#.#.#.........#...#...#.#.#.#.........#...#...#...#.#.#.#.....#.#.....#.#.#.#...........#.....#
###...###..##.#####....########...#####.###...#####.#.###.#.###..######.#...#####...#.###.#...###.#....##...#.#.#####..##.###..##
#.#...#.......#.#.#.......#...#.#.......#.#.#.#...#.#.#...#.#.......#...#.#.#.#...#.#.#...#.#.#...#.#...#...#.#.#.......#.#.....#
#.###.###.....#...#####...#..####.###.###...#.....#####..##.###.#######.#.###.#..####.###.#.###..####..####...#.#..####.#####...#
#.#.......#.#.#.........#.#.....#.#.#.#.....#...#.#.#.........#.#...#...#.....#.....#.....#.#.....#.#.........#.#...#.#.....#.#.#
#.#####...#.###....##.#####.....###.###.###.#####.#.#####.......#..##########.#######...###.#.###...###..##...#.#####...###...###
#.......#.#.#...#...#.#.....#.#...#...#.#.#.#.....#.#...#.#.#...#.....#...#.......#.#.#.#...#.#.....#.#...#.#.#...#.#...#.....#.#
###.#########.#####.#.#######.#######.#.#.#.###...#.....#.#.#..##.###....##..######.#.###########..##.#.#####.#..##.#...#.......#
#...#.#...#...#...#.#...........#.....#.#.#...#.#.#...#.#.#.#...#.#.#.............#.#.....#..ee.......#.#.....#...#.#.#.#.#.#...#
###.#.###.#####...###.#############.###.#.###.###.#...###.#.#####...###......####.#.###...#...#####.....###.#######.###.#######.#
#...#.#.#.......#.#.#.#.#...#.......#...#.......#.#.#.....#.........#.#.#.#...#...#...#.#.#.#.#...#.#...#.#.#.....#...........#.#
###...#.#########...###.#..######......####..##########...#..####.###.###.#.#####...###.#######...###...#.###.###.###..##.###.#.#
#.#...#.#...........#...#.....#...#.......#...#.....#.#.#.#...#...#...#...#.#.......#.....#.....#.#.#.#.#.#.#.#.....#...#.#...#.#
#.###.....###..##...###.###.#####.###...#####.#.#####.#.#.#...#.###..######.#####...#.#####.....#.....#.#...###..############.###
#.#.......#.....#.#...#.....#.......#.#.#.....#.#...#.#.#.#.#.#.#.....#.#.#.....#.#.#.#.....#.#.#.....#.#...#.......#...#.....#.#
#.#......##.###.#######....######..####.#.###...###.#.#########....##...#.#######.###.#..######.###..######.....#####..########.#
#.#.#.#...#.#.........#.#...eee.....#...#.#.#.......#.....#.........#...#.....#.....#.#...#.....#.....#.......#.#...#...#...#...#
#.###.###.#########.#######......##.#.###.#.###....####.....###..######...#######.###.###.#..####..######..######..####...#####.#
#.#.....#.#.....#...#.#...#.#.#...#.#.#...#.#...#.......#...#.........#...#...#...#.#.#...#...#...e...#.#...#.............#.....#
#.....###.#.....#####.....#####...#.#####...###.#######.###.#####..######.#......##...###.#####......e..###.#####.#####.###....##
#...#.#...#.#.#.#.#.....#.......#.#.#.......#.........#.#...#...........#.#.#.....#...#.#.#.....#.#.#.....#...#...#.....#...#...#
#######.#######...#....####..##.#####..####.#....####.###.###.#########.###.#...###...#...#########.#####.###...###.###.....#####
#.....#.#.#.......#.#.....#...#...#.#.....#.#.#.....#...#.#...#...........#.#.#.#...#.#...#.#.#.#.....#.#.......#.#.#.#...#.#...#
###..##....e..#####.#####.#########.#####.#######.###...#####.#..####..######.#######....##.#.#.#######.###...###...#....##...###
#..........e#.#.#.#.#...........#.......#...#.#...#.#.#.#.....#...#.........#...#...#.......#.#.............#.#.#...#.....#...#.#
#.#######.e.###...###.#######.###..####.#..##....##.#.#.#.....#..####..##########..######..##.#.###..######.###.#####..########.#
#.#...#.#.#...#.....#.#.......#.....#...#...#.......#.#.#.#.#.#...#.......#.#.#.....#.........#.#.....#.#...........#...#...#...#
#.###.#...#..######...#...###.#####.###.....###.###.###.#####.###.#######.e...#..####..##..######.#####......########..##......##
#.....#...#.....#.....#.#.#...#.......#...#...#.#.....#.#.......#.#.......e...#.........#.....#...#.......#...#...........#.....#
#################################################################################################################################
